Elefante - animal
Aquarela - arte
Relâmpago - fenômeno
Biblioteca - lugar
Girassol - planta
Pirâmide - estrutura
Oceano - natureza
Muralha - construção
Cometa - espaço
Esmeralda - joia
Pinguim - ave
Riacho - curso
Vulcão - geografia
Safira - mineral
Tapete - objeto
Formigueiro - habitação
Constelação - astros
Manjericão - erva
Abóbora - vegetal
Saxofone - música
Cachoeira - paisagem
Asteroide - corpo
Chalé - moradia
Cisne - aquático
Catedral - edificação
Cachorro - doméstico
Golfinho - marítimo
Samambaia - folhagem
Rubrica - assinatura
Oásis - deserto
Gorila - primata
Rubi - gema
Savana - ecossistema
Flauta - sopro
Ilustração - desenho
Trampolim - esporte
Relógio - tempo
Guitarra - cordas
Orquídea - flor
Cantil - acessório
Papiro - antigo
Enigma - mistério
Montanha - elevação
Pomar - frutas
Sereia - mitologia
Águia - rapina
Névoa - clima
Esfinge - monumento
Luneta - observação
Carrossel - diversão
Mosaico - artefato
Serenata - música
Esqueleto - corpo
Fóssil - história
Horizonte - linha
Estátua - escultura
Labirinto - caminho
Mariposa - inseto
Espantalho - figura
Lagoa - água
Vitral - janela
Planície - terreno
Monastério - religião
Mural - parede
Caleidoscópio - brinquedo
Labareda - fogo
Passarinho - pequeno
Répteis - classe
Borboleta - voador
Cascata - queda
Arquipélago - grupo
Estrela - céu
Muralha - defesa
Folhagem - verde
Pedra - mineral
Sombra - luz
Neblina - matutino
Deserto - árido
Cruzada - missão
Horizonte - distante
Fortaleza - proteção
Enxame - insetos
Girassol - amarelo
Cisterna - água
Harpa - instrumento
Cactos - espinhoso
Santuário - sagrado
Bússola - direção
Esquadrilha - aviões
Miragem - ilusão
Pedreira - mineração
Desfiladeiro - estreito
Baleia - gigante
Alga - aquática
Planeta - celeste
Lava - magma
Lareira - calor
Geleira - gelo
Obelisco - monumento
Recife - coral
Cânion - erosão
Coruja - noturno
Luau - festa
Vento - ar
Pirata - mar
Paisagem - vista
Bumerangue - volta
Explosão - impacto
Rochoso - pedregulho
Abelhas - mel
Pirâmide - Egito
Relva - gramado
Traço - linha
Anfíbio - dupla
Eclipse - sombra
Zepelim - ar
Navegar - água
Botânico - plantas
Vagalume - luz
Infinito - sem fim
Riacho - pequeno
Ilustração - visual
Garrafa - líquido
Marinheiro - mar
Explorador - aventura
Sinfonia - música
Arquipélago - ilhas
Tsunami - onda
Aurora - luz
Tremor - terra
Cavalgada - cavalo
Veleiro - barco
Vitrine - exposição
Explosão - barulho
Espetáculo - show
Minério - extração
Guarita - proteção
Trincheira - guerra
Cultivo - agricultura
Galeria - arte
Bordado - costura
Canoa - remos
Satelite - órbita
Erupção - vulcão
Nevasca - neve
Jangada - flutuação
Refúgio - abrigo
Pescador - peixe
Galáxia - espaço
Nebulosa - estrela
Palmeira - tropical
Lavagante - marinho
Metamorfose - mudança
Observatório - céu
Vertigem - altura
Rascunho - desenho
Conífera - árvore
Vespa - inseto
Erosão - desgaste
Cachalote - marinho
Granizo - gelo
Lanterna - luz
Muralha - proteção
Petroleiro - navio
Cúpula - teto
Desabamento - queda
Manguezal - área
Revoada - pássaros
Dique - barragem
Estufa - plantas
Mirante - vista
Desbravador - explorar
Coral - mar
Escultura - arte
Astro - corpo
Eólica - vento
Aurora - boreal
Labirinto - caminho
Montagem - peças
Ravina - desfiladeiro
Ermida - capela
Bússola - navegação
Biodiversidade - vida
Atemporal - tempo
Corredeira - rio
Monumento - histórico
Névoa - clima
Perímetro - borda
Manancial - água
Penhasco - altura
Quintal - casa
Residência - moradia
Cascata - água
Bosque - árvores
Astronomia - ciência
Desfiladeiro - vale
Meteorito - queda
Nebulosa - galáxia
Turista - viagem
Vulcão - erupção
